1111111111111111111111111111111111111111111111111111111111111111
1111111111111111111111111111111111111111111111111111111111111111
1111111111111111111111111111111111111111111111111111111111111111
1111111111111111111111111111111111111111111111111111111111111111
1111111111111111111111111111111111111111111111111111111111111111
1111111111111111111111111111111111111111111111111111111111111111
1111111111111111111111111111111111111111111111111111111111111111
1111111111111111111111111111111111111111110000000111111111111111
1111111111111111111111111111111111111111100000000011111111111111
1111111111100000001111111111111111111111000000000000111111111111
1111111111000000000111111111111110000010000000000000000000111111
1111111111000000000111111111111100000000000111100000000000001111
1111111111000000000011111111111000000000001111110000000000001111
1111111111000000000000011111111000000000011111110000000000000111
1111111111000000000000001111111000000000011111110000000000000011
1111111111000000000000000111111000000000011111111000000000000011
1111111111100000000000000111111100000000011111111000000000000011
1111111111100000000000001111111110000001111111111000000000001111
1110000111100000000000000011111111111111111111111000000000011111
1100000011000000000000000001111111111111111111110000000000111111
1000000000000000000000000000111111111111111111110000000000111111
1000000000000000000000000000011111111100001111110000000000111111
1000000000000000000000000000001111100000000001100000000000111111
1100000000000000000000000000000000000000000000000000000001111111
1100000000000000000000000000000000000000000000000000000011111111
1110000000000000000000000000000000000000000000000000000011111111
1111000000000000000000000000000000000000000000000000000001111111
1111110000000000000000000000000000000111111111111110000000111111
1111111000000000000000000000011111111111111111111111000000011111
1111111000000000000011111111111111111111111111111111000000011111
1111110000000111111111111111111111111111111111111111000000001111
1111100000001111111111111111111111111111111111111110000000001111
1111100000001111111111111111111111111110000000000000000000001111
1111100000000111111111111111111100000000000000000000000000011111
1111110000000011111111111000000000000000000000000000000000011111
1111111000000000000000000000000000000000000000000000000000111111
1111111100000000000000000000000000000000000000000000000001111111
1111111100000000000000000000000000000000000000000000000001111111
1111111000000000000000000000000000000000000000000000000000111111
1111110000000000001111100000000011000000000000000000000000011111
1111110000000000011111111000111111110000000000000000000000001111
1111110000000000011111111111111111111000000000000000000000000111
1111110000000000111111111111111111111100000000000000000000000111
1111100000000000111111111111000111111100000000000000000000000011
1111000000000000111111111100000000011110000000000000000000000011
1110000000000000111111111000000000001110000000000000000000000011
1110000000000000011111110000000000001111000000000000000000000011
1100000000000000011111110000000000001111000000000000011000000111
1100000000000000011111100000000000001111000000000000111100001111
1110000000000000001111000000000000001111000000000000111111111111
1111000000000000000000000000000000011111100000000000011111111111
1111100000000000000000000000000000111111100000000000001111111111
1111100000000000000000000111000011111111110000000000001111111111
1111110000000000000000001111111111111111111000000000001111111111
1111111111000000000000011111111111111111111100000000001111111111
1111111111111111110000111111111111111111111110000000001111111111
1111111111111111111111111111111111111111111111000000001111111111
1111111111111111111111111111111111111111111111100000011111111111
1111111111111111111111111111111111111111111111111111111111111111
1111111111111111111111111111111111111111111111111111111111111111
1111111111111111111111111111111111111111111111111111111111111111
1111111111111111111111111111111111111111111111111111111111111111
1111111111111111111111111111111111111111111111111111111111111111
1111111111111111111111111111111111111111111111111111111111111111
